1111111111111111111111111
1000000000000000000000001
10001111111100000000000C1
1000000000010000000000001
10001100C0010000000P00001
10001100000100000000E0001
1111111111111111111111111
