1111111
1000P01
1000011
1000C01
1000E01
1111111
