11111111111
10000000001
10011110001
1000C000001
1000P000E01
11111111111
