1111111111111111111111
1000000000000000000001
1001111000111100010001
100000C0000000100C0001
1000000000000010P00001
1000000000000000E00001
1111111111111111111111
