1111111
1C00001
100P001
1000001
1000E01
1111111
