111111111111
100000000001
100111111101
1C0000000001
1000P0000E01
111111111111
