NO textures/test/forbidden.xpm
SO textures/test/south.xpm
WE textures/test/west.xpm
EA textures/test/east.xpm

C 225,30,0
F 255,10,0



            1111111111111111111111111
            100000000011000000000
            1011000001110000000000001
            1001000000000000000000001
111111111011000001110000000000001           111111111
100000000011000001110111111111111           100000001
11110111111111011100000010001               100000111
11110111111111011101010010001               11000011
11000000110101011100000010001               111001111
10000000000000001100000010001               111111111
10000000000000001101010010001
11000001110101011111011110N0111
11110111 1110101 101111010001
11111111 1111111 111111111111