111111111111
10001100C001
1P00000001E1
111111111111
