1111111
1000001
1000C01
100P001
1000E01
1111111
