111111111
100000001
100111101
10C000C01
101111101
1000P0001
1000000E1
111111111
