11111111111
10000000001
10C11111001
10000000001
10111111101
10C00000C01
100P0000001
10111111101
100000000E1
11111111111
