1111111111111
1000000000001
10C1111111001
1000000000001
1011111111101
10C00000000C1
100000P000001
1111011111011
10000C0000C01
10000000000E1
1111111111111
