111111111111111
100000000000001
10C111111111101
100000000000001
101111111111101
10C00000000C001
100011111110001
100P00000000001
111111101111111
10000000C0000E1
100000000000001
101111111111101
10C00000000C001
111111111111111
